NO AHOJ
EA Yo
SO cubenzi
WE here
C 100, 200, 200
F 220, 200, 200

111111111111111111111111111111111
100000001               100000001
100000001          11111100000001
100000000000000000000000000000001
100000000000000000000000000000001
100000000000000000000000000000001
 1000000000000000000000000000001
  10000000000000000000000000001
   100000000000000000000000001
    1000000000000000000000001
     10000000000000000000001
      100000000000000000001
       1000000000000000001
        10000000000000001
         100000000000001
          1000000000001
           10000000001
            100000001
             1000001
              10001
               101
                1
