NO AHOJ
EA Yo
SO cubenzi
WE here
C 100, 200, 200
F 220, 200, 200

111111
1E0001
111111
